#,#,#,#,#,#,#,#,#
#,,,,,,,,#
#,,,,,,,,#
#,,,,,,,,#
#,,,,,,,,#
#,,,#,,,,,#
#,,,#,,,,,#
#,,,#,,,,,#
#,,,#,,,,,#
#,,,#,,,,,#
#,,,#,,,,,#
#,,,#,,,,,#
#,,,#,,,,,#
#,,,#,,,,,#
#,#,#,#,#,#,#,#,#